'aight = alright
aren't = are not
can't = cannot
'cause = because
could've = could have
couldn't = could not
couldn't've = could not have
didn't = did not
doesn't = does not
don't = do not
everybody's = everybody is
everyone's = everyone is
gonna = going to
gotta = got to
hadn't = had not
hasn't = has not
haven't = have not
he'd = he would
he'll = he will
he's = he is
he've = he have
how'd = how did
howdy = how do you do
how'll = how will
how're = how are
how's = how is
I'd = I would
I'll = I will
I'm = I am
I've = I have
isn't = is not
it'd = it would
it'll = it will
it's = it is
let's = let us
ma'am = madam
may've = may have
might've = might have
mustn't = must not
must've = must have
needn't = need not
o'clock = of the clock
ol' = old
she'd = she would
she'll = she will
she's = she is
should've = should have
shouldn't = should not
shouldn't've = should not have
somebody's = somebody is
someone's = someone is
something's = something is
that'll = that will
that're = that are
that's = that is
that'd = that would
there'd = there would
there'll =  there will
there're = there are
there's = there is
these're = these are
these've = these have
they'd = they would
they'll = they will
they're = they are
they've = they have
those're = those are
those've = those have
to've = to have
wanna = want to
wasn't = was not
we'd = we had
we'd've = we would have
we'll = we will
we're = we are
we've = we have
weren't = were not
what'd = what did
what'll = what will
what're = what are
what's = what is
what've = what have
when's = when is
where'd = where did
where'll = where will
which'll = which will
who'd = who would
who'd've = who would have
who'll = who will
who're = who are
who's = who is
who've = who have
why'd = why did
why're = why are
why's = why does
won't = will not
would've = would have
wouldn't = would not
wouldn't've = would not have
y'all = you all
you'd = you would
you'll = you will
you're = you are
you've = you have